111111
130001
101201
101001
100011
111111